11111111
10000001
100000P1
1S00C001
10000001
110000C1
1E000001
11111111
