1111111111
10000001C1
1P0E000111
1111111111
